Rammstein	Engel	engel.mp3
Owl_City	Fireflies	fireflies.mp3
Vulfpeck	Dean_town	deantown.mp3
Sepultura	Roots_bloody_roots	rootsbloodyroots.mp3
George_Isaacs	House_of_the_rising_sun	houseoftherisingsun.mp3
Etienne_de_Crécy	Binary	binary.mp3
Sona_Jobarteh	Gambia	gambia.mp3
Blur	Intermission	intermission.mp3
The_Prodigy	Invaders_must_die	invadersmustdie.mp3
R_Wan	Le_CRS_Mélomane	LeCRSmelomane.mp3
Harry_Belafonte	Jump_in_the_line	jumpintheline.mp3
Kacem_Wapalek	Le_temps_passe	letempspasse.mp3
Les_Cowboys_Fringants	La_Marine_Marchande	marinemarchande.mp3
The_Toots_and_the_martyals	Pressure_drop	pressuredrop.mp3
Brigitte_Fontaine	Prohibition	prohibition.mp3
Les_chiens_de_ruelles	Roadtrip	roadtrip.mp3
Médine	Grand_Médine	grandmedine.mp3
Bonnie_Tyler	Total_eclipse_of_the_heart	totaleclipseoftheheart.mp3
Hubert_Felix_Thiefaine	Lorelei	lorelei.mp3
Paolo_Conte	Come_Di	comeDi.mp3
